11111111111111
11000000010001
101C100001C001
1001000C110001
100010CP110001
100C110C000CC1
100000000001E1
11111111111111